sample-id	Rep	Agar	Microbiome
#q2:types	categorical	categorical	categorical
Blank_1	Blank	Blank	Blank
Blank_2	Blank	Blank	Blank
S1_PPxPP	PPxPP	Palmaria	Palmaria
S10_PPxOP	PPxOP	Palmaria	Osmundea
S100_IRxOP	IRxOP	Chondrus	Osmundea
S101_IRxCE	IRxCE	Chondrus	Ceramium
S102_IRxCE	IRxCE	Chondrus	Ceramium
S103_IRxCE	IRxCE	Chondrus	Ceramium
S104_IRxIR	IRxIR	Chondrus	Chondrus
S105_IRxIR	IRxIR	Chondrus	Chondrus
S106_IRxIR	IRxIR	Chondrus	Chondrus
S109_IRxOP	IRxOP	Chondrus	Osmundea
S11_PPxOP	PPxOP	Palmaria	Osmundea
S110_IRxOP	IRxOP	Chondrus	Osmundea
S12_PPxOP	PPxOP	Palmaria	Osmundea
S13_PPxCE	PPxCE	Palmaria	Ceramium
S14_PPxCE	PPxCE	Palmaria	Ceramium
S15_PPxCE	PPxCE	Palmaria	Ceramium
S16_PPxIR	PPxIR	Palmaria	Chondrus
S17_PPxIR	PPxIR	Palmaria	Chondrus
S18_PPxIR	PPxIR	Palmaria	Chondrus
S19_BExPP	BExPP	Lomentaria	Palmaria
S2_PPxPP	PPxPP	Palmaria	Palmaria
S20_BExPP	BExPP	Lomentaria	Palmaria
S21_BExPP	BExPP	Lomentaria	Palmaria
S22_BExBE	BExBE	Lomentaria	Lomentaria
S23_BExBE	BExBE	Lomentaria	Lomentaria
S24_BExBE	BExBE	Lomentaria	Lomentaria
S25_BExFE	BExFE	Lomentaria	Calliblepharis
S26_BExFE	BExFE	Lomentaria	Calliblepharis
S27_BExFE	BExFE	Lomentaria	Calliblepharis
S28_BExOP	BExOP	Lomentaria	Osmundea
S29_BExOP	BExOP	Lomentaria	Osmundea
S3_PPxPP	PPxPP	Palmaria	Palmaria
S30_BExOP	BExOP	Lomentaria	Osmundea
S31_BExCE	BExCE	Lomentaria	Ceramium
S32_BExCE	BExCE	Lomentaria	Ceramium
S33_BExCE	BExCE	Lomentaria	Ceramium
S34_BExIR	BExIR	Lomentaria	Chondrus
S35_BExIR	BExIR	Lomentaria	Chondrus
S36_BExIR	BExIR	Lomentaria	Chondrus
S37_FExPP	FExPP	Calliblepharis	Palmaria
S38_FExPP	FExPP	Calliblepharis	Palmaria
S39_FExPP	FExPP	Calliblepharis	Palmaria
S4_PPxBE	PPxBE	Palmaria	Lomentaria
S40_FExBE	FExBE	Calliblepharis	Lomentaria
S41_FExBE	FExBE	Calliblepharis	Lomentaria
S42_FExBE	FExBE	Calliblepharis	Lomentaria
S43_FExFE	FExFE	Calliblepharis	Calliblepharis
S44_FExFE	FExFE	Calliblepharis	Calliblepharis
S45_FExFE	FExFE	Calliblepharis	Calliblepharis
S46_FExOP	FExOP	Calliblepharis	Osmundea
S47_FExOP	FExOP	Calliblepharis	Osmundea
S48_FExOP	FExOP	Calliblepharis	Osmundea
S49_FExCE	FExCE	Calliblepharis	Ceramium
S5_PPxBE	PPxBE	Palmaria	Lomentaria
S50_FExCE	FExCE	Calliblepharis	Ceramium
S51_FExCE	FExCE	Calliblepharis	Ceramium
S52_FExIR	FExIR	Calliblepharis	Chondrus
S53_FExIR	FExIR	Calliblepharis	Chondrus
S54_FExIR	FExIR	Calliblepharis	Chondrus
S55_OPxPP	OPxPP	Osmundea	Palmaria
S56_OPxPP	OPxPP	Osmundea	Palmaria
S57_OPxPP	OPxPP	Osmundea	Palmaria
S58_OPxBE	OPxBE	Osmundea	Lomentaria
S59_OPxBE	OPxBE	Osmundea	Lomentaria
S6_PPxBE	PPxBE	Palmaria	Lomentaria
S60_OPxBE	OPxBE	Osmundea	Lomentaria
S61_OPxFE	OPxFE	Osmundea	Calliblepharis
S62_OPxFE	OPxFE	Osmundea	Calliblepharis
S63_OPxFE	OPxFE	Osmundea	Calliblepharis
S64_OPxOP	OPxOP	Osmundea	Osmundea
S65_OPxOP	OPxOP	Osmundea	Osmundea
S66_OPxOP	OPxOP	Osmundea	Osmundea
S67_OPxCE	OPxCE	Osmundea	Ceramium
S68_OPxCE	OPxCE	Osmundea	Ceramium
S69_OPxCE	OPxCE	Osmundea	Ceramium
S7_PPxFE	PPxFE	Palmaria	Calliblepharis
S70_OPxIR	OPxIR	Osmundea	Chondrus
S71_OPxIR	OPxIR	Osmundea	Chondrus
S72_OPxIR	OPxIR	Osmundea	Chondrus
S73_CExPP	CExPP	Ceramium	Palmaria
S74_CExPP	CExPP	Ceramium	Palmaria
S75_CExPP	CExPP	Ceramium	Palmaria
S76_CExBE	CExBE	Ceramium	Lomentaria
S77_CExBE	CExBE	Ceramium	Lomentaria
S78_CExBE	CExBE	Ceramium	Lomentaria
S79_CExFE	CExFE	Ceramium	Calliblepharis
S8_PPxFE	PPxFE	Palmaria	Calliblepharis
S80_CExFE	CExFE	Ceramium	Calliblepharis
S81_CExFE	CExFE	Ceramium	Calliblepharis
S82_CExOP	CExOP	Ceramium	Osmundea
S83_CExOP	CExOP	Ceramium	Osmundea
S84_CExOP	CExOP	Ceramium	Osmundea
S85_CExCE	CExCE	Ceramium	Ceramium
S86_CExCE	CExCE	Ceramium	Ceramium
S87_CExCE	CExCE	Ceramium	Ceramium
S88_CExIR	CExIR	Ceramium	Chondrus
S89_CExIR	CExIR	Ceramium	Chondrus
S9_PPxFE	PPxFE	Palmaria	Calliblepharis
S90_CExIR	CExIR	Ceramium	Chondrus
S91_IRxPP	IRxPP	Chondrus	Palmaria
S92_IRxPP	IRxPP	Chondrus	Palmaria
S93_IRxPP	IRxPP	Chondrus	Palmaria
S94_IRxBE	IRxBE	Chondrus	Lomentaria
S95_IRxBE	IRxBE	Chondrus	Lomentaria
S96_IRxBE	IRxBE	Chondrus	Lomentaria
S97_IRxFE	IRxFE	Chondrus	Calliblepharis
S98_IRxFE	IRxFE	Chondrus	Calliblepharis
S99_IRxFE	IRxFE	Chondrus	Calliblepharis
